8
8
########
#A..4..#
#AA...B#
#a..#b.#
#..55..#
#a.#..2#
#1..BBb#
########
