8
8
########
#A..2.B#
#AA.b.B#
#..###.#
#1a.#..#
#.b.#a.#
#..55.B#
########
