8
8
########
#2a.#..#
#A..#..#
#AA...B#
#a..3.b#
#..###b#
#1..BB.#
########
