8
8
########
#A.3...#
#AA..#B#
#..#..b#
#a.55#.#
#a..#..#
#..1BBb#
########
