8
8
########
#A..#..#
#AA..4B#
#a.###b#
#..55..#
#2..#..#
#..BB1b#
########
