8
8
########
#A..#..#
#AA.#.B#
#a..#..#
#.####.#
#4a.55b#
#..BB..#
########
