8
8
########
#5..bBB#
#.....B#
#..55.b#
#a.55..#
#A.....#
#AAa..5#
########